Canada	加拿大
thanks	谢谢
student	学生
four	四
five	五
over	在那边
Jones	琼斯（姓）
homeroom	年级教室
classmate	同班同学
visiting	访问的
show	指示；带路
around	到处
classroom	教室
office	办公室
plan	计划
fun	有趣的事；玩笑
lab	实验室
eraser	橡皮擦
guess	猜测
first	第一；首先
wall	墙
may	可以
excuse	原谅
borrow	借
two	二
three	三
store	商店
later	后来
thing	东西；事情
need	需要
list	名单；目录
ten	十
six	六
seven	七
one	一
nine	九
eight	八
sure	当然
blouse	女衬衫
really	真正地
pink	粉色（的）
paint	绘画；涂料
mix	混合
rainbow	彩虹
purple	紫色（的）
out	在外面
sky	天空
scarf	围巾
glove	手套
maybe	也许
just	恰恰；刚刚
catch	抓住；染上（病）
ready	准备好的
dinosaur	恐龙
T-shirt	短袖汗衫
jacket	夹克
forget	忘记
hat	（有边的）帽子
pants	裤子
colourful	丰富多彩的
so	非常；那么
bright	明亮的；耀眼的
world	世界
report	报告
traditional	传统的
sari	莎丽（印度服装）
India	印度
uniform	制服
pretty	漂亮的
centre	中心
Saturday	星期六
will	将要
pair	双；对
part	部分
feeling	感觉；情感
robot	机器人
camera	照相机
smell	闻起来
finger	手指
player	运动员；选手
homework	家庭作业
singer	歌手
question	问题
sick	生病的
scared	恐惧的
smile	微笑
wave	挥手
mean	刻薄的；意思是
metre	米
bit	少量；小量
against	靠着；反对
tail	尾部
flat	水平地
upon	在……上面
ground	地面
hurt	痛的；疼痛
donut	面包圈
enough	足够的（地）
laugh	笑
stomachache	胃痛
better	更好的
Dr.	医生
matter	问题
headache	头痛
medicine	药
stay	停留
rest	休息
different	不同的
cute	漂亮的；可爱的
twelve	十二
blond	金色（的）
thirteen	十三
funny	有趣的
almost	几乎
glass	玻璃；眼镜（-es）
restaurant	餐馆
fifteen	十五
cereal	谷类食物
would	将；愿意
salad	色拉
sugar	糖
delicious	美味的
cup	杯子
full	满的
cookie	饼干
chocolate	巧克力
everything	一切事物
meat	肉
job	工作
market	市场
grape	葡萄
carrot	胡萝卜
cabbage	洋白菜；卷心菜
watermelon	西瓜
sweet	甜的
pear	梨
waitress	女服务员
order	订购；点餐；顺序
fourteen	十四
beef	牛肉
eleven	十一
dumpling	饺子
something	某事物
problem	问题；难题
menu	菜单
can	（装饮料的）金属罐
coke	可乐
bottle	瓶子
corner	角落
money	钱
clerk	职员
fridge	冰箱
twenty	二十
pass	传递；经过
away	离开
sandwich	三明治
takeout	外卖食品
tip	指点；提示
only	仅仅；只
P.S.	附言
member	成员
son	儿子
daughter	女儿
drive	驾驶
policeman	（男）警察
radio	收音机
businessman	商人
weekend	周末
together	一起
others	其他人
hard	努力/艰难的（地）
bedroom	卧室
dictionary	字典
front	前面
above	在……之上
thirty	三十
picnic	野餐
carry	携带；搬运
basket	篮子
tablecloth	桌布
lot	许多
quiet	安静的
paper	纸张
inside	在里面
poem	诗歌
rose	玫瑰
riddle	谜语
present	礼物
soft	软的
woof	汪汪（狗叫声）
set	摆放；落下
teacup	茶杯
bookstore	书店
ride	乘坐
broken	坏的
off	离开；关上
lost	迷路的
lady	女士
traffic	交通
straight	直的/地
luck	幸运
fresh	新鲜的
follow	跟随；明白
count	数
forty	四十
fifty	五十
sixty	六十
seventy	七十
eighty	八十
ninety	九十
hundred	百
dream	梦；梦想；做梦
noise	响声；噪音
lion	狮子
lonely	孤独的
miss	想念；错过
forest	森林
course	过程；经过
countryside	郊外；乡村
feed	喂养
pick	采摘；选择
friendly	有好的
quickly	迅速地
moo	哞（牛叫声）
museum	博物馆
hall	大厅；会堂；走廊
famous	著名的
painting	绘画
boring	无聊的
war	战争
learn	学习
history	历史
area	区域；面积
gift	礼物
movie	电影
theatre	剧院
kung fu	功夫
price	价格
hero	英雄
save	解救；节省
airport	飞机场
hotel	旅馆
magic	魔术的；神奇的
fight	搏斗；打架
Monday	星期一
rainy	多雨的
swimming	游泳
Tuesday	星期二
outside	在外面
Wednesday	星期三
Thursday	星期四
snowy	下雪的
skate	滑冰
mark	标记
calendar	日历
December	十二月
best	最好的
Friday	星期五
Christmas	圣诞节
eve	前夕
Sunday	星期天
sale	出售
midnight	午夜
date	日期；约会
January	一月
March	三月
June	六月
second	第二
February	二月
third	第三
fourth	第四
fifth	第五
May	五月
sixth	第六
August	八月
September	九月
November	十一月
leap	跳跃
seventh	第七
July	七月
eighth	第八
ninth	第九
tenth	第十
October	十月
eleventh	第十一
twelfth	第十二
present	介绍；礼物
international	国际的
national	国家的；民族的
festival	节日
usually	通常地
during	在……期间
mountain	山脉
climb	攀登
excited	兴奋的
beach	沙滩
Australia	澳大利亚
hope	希望
yours	你的；你们的
direction	方向
north	北方
south	南方
east	东方
west	西方
point	指向
country	国家
New Zealand	新西兰
grandparent	（外）祖父母
southeast	东南
U.S.	美国
soon	不久
invite	邀请
everyone	每个人
Sydney	悉尼
London	伦敦
capital	首都
U.K.	英国
Washington D.C.	华盛顿特区
Vancouver	温哥华
language	语言
else	其他
flag	旗帜
palace	宫殿
the Palace Museum	故宫
lovely	可爱的
French	法国的；法语
Ottawa	渥太华
leaf	叶子
beaver	海狸
Niagara Falls	尼亚加拉大瀑布
waterfall	瀑布
stripe	条
eagle	鹰
statue	雕像
liberty	自由
Statue of Liberty	自由女神像
New York	纽约
same	相同的
as	和……一样；作为
Big	Ben	大本钟
tower	塔
Canberra	堪培拉
kangaroo	袋鼠
opera	歌剧（院）
Sydney Opera House	悉尼歌剧院
Singapore	新加坡
Africa	非洲
South Africa	南非
trip	旅行，旅程
silk	丝绸
road	公路
lead	带领
note	笔记
chance	机会
send	邮寄；发送
news	新闻；消息
exciting	使人激动的
along	沿着
kilometre	千米；公里
special	特殊的
culture	文化
arrive	到达
Terra Cotta Warrior	兵马俑
leave	离开
Wild Goose Pagoda	大雁塔
hit	击中
ancient	古代的
drum	鼓
ring	打电话；按铃；敲钟
bell	钟；铃
enjoy	喜欢；享受
dish	菜肴
tour	旅游；旅行
guide	导游；向导
pit	深坑；陷阱
move	移动
sign	记号；招牌
group	群；组；团体
bridge	桥梁
cross	横跨；横穿
wide	宽的；广泛的
cheese	奶酪
another	另一个；另外的
amazing	惊奇的
main	主要的
sand	沙地
cave	山洞
believe	相信
camel	骆驼
sir	先生
safe	安全的
fall	落下
onto	到……上面
yay	哇（因高兴而欢呼）
diary	日记
last	最后的；上一个
clothing	衣物
nest	鸟巢
few	少数的；很少的
building	建筑物
hold	举行；拿着
Olympics	奥林匹克竞赛；奥运会
thousand	千
instrument	乐器；仪器
someday	将来有一天
project	课题；计划
interest	兴趣
still	仍旧；静止的
anywhere	任何地方
joke	（开）玩笑
Italy	意大利
age	年龄
goods	商品
Europe	欧洲
Asia	亚洲
journey	旅行
king	国王
coal	煤
discover	发现
invent	发明；创造
other	其他的
describe	描述
build	建造
ago	以前
army	军队
clay	黏土
soldier	士兵
important	主要的
tool	工具
desert	沙漠
more	更多
realize	认识到；实现
rich	丰富的；富有的
western	西方的；西式的
violin	小提琴
dancer	舞者
online	在线的；联网的
especially	尤其；特别
treasure	财富；宝物
end	最后；末端
product	产品
worth	值得；有价值的
hand-made	手工的
taste	品尝；体验
true	真实的
supper	晚餐
once	从前；一次
blog	博客
experience	体验；经历
alive	活着的；有活力的
own	自己的
should	应该；将要
anyone	任何人；无论谁
suggestion	建议
yum	好吃
life	生活
term	学期
start	开始
finish	结束；完成
twice	两次；两倍
win	获胜
yeah	是；对
social	社会的
shop	手工艺课
myself	我自己
middle	中等的
grade	年级
wood	木头
print	印刷
guitar	吉他
fair	展览会
worm	蠕虫
silk	worm	蚕
difference	区别
village	村庄
education	教育
yourself	你自己
drop	放弃；停止
possible	可能的
never	从不
future	未来
Riverside	河畔
terrible	可怕的
happen	发生
lose	失去；失败
fire	火；火灾
raise	募捐（钱财）
prize	奖品；奖赏
video	视频；录像
piece	张；片
visitor	参观者
teach	讲授；教
quite	非常；十分
nervous	紧张的
comfortable	舒服的
relaxed	放松的
helpful	有帮助的
activity	活动
volleyball	排球
practice	练习
chess	国际象棋
club	俱乐部
volunteer	自愿帮助；志愿者
bingo	宾戈游戏
both	两者
nothing	什么都没
join	参加
improve	提高；改善
thinking	理性的
skill	技能
challenge	挑战
meeting	聚会；会议
act	行动；扮演
useful	有用的
role	角色；职能
team	队；组
shape	形状
level	水平
pool	水塘
type	类型
following	接着的；下述的
which	哪一个
circle	圆圈；圈出
add	增加；添加
score	得分；分数
relax	放松
free	空闲的；自由的
mind	头脑；思想
active	积极的；活跃的
quietly	安静地；平静地
must	必须
without	没有；不用
bored	无聊的
example	范例
hurry	赶紧；匆忙
somewhere	在某处
actually	的确；真实地
cooking	烹调
surf	冲浪
Internet	网络
housework	家务劳动
phone	电话；打电话
bookworm	书虫，书迷
anything	任何事物
grocery	杂货
expensive	昂贵的
yummy	美味的
everybody	每人
foreign	外国的
could	可能；能
loudly	大声地
understand	懂得；理解
cartoon	动画片；漫画
Canadian	加拿大（人）的
Russia	俄罗斯
reply	回答；答复
competition	比赛；竞赛
proud	自豪的
such	那么的；这样的
letter	字母
exactly	确切地；精确地
fact	事实
sentence	句子
quick	快的
fox	狐狸
lazy	懒惰的
forwards	向前
backwards	向后
therein	在那里；在其中
even	甚至；其实
dig	挖；掘
Hong	Kong	香港
storybook	故事书
magazine	杂志
newspaper	报纸
mistake	错误
silly	愚蠢的
article	文章
opportunity	机会
knowledge	知识
communicate	交流
connect	连接
pal	伙伴；朋友
introduce	介绍
strange	奇怪的
notice	注意；宣告
wild	怪异的
wake	醒
surprised	感到惊讶的
become	变得；成为
dark	黑暗（的）
ski	滑雪
snowball	雪球
research	研究；调查
website	网站
hill	小山	ice	冰
snowman	雪人
clear	晴朗的；清澈的
temperature	温度
pie	馅饼
clap	拍手；鼓掌
happily	幸福地
maple	枫树
syrup	糖浆
goose	雁；鹅
honk	雁/鹅叫声；汽车喇叭声
cloud	云
wet	湿的
surfing	冲浪运动
mate	朋友；伙伴
reach	到达
degree	度数
sea	海洋
surfboard	冲浪板
popular	流行的；普及的
surfer	冲浪者
everywhere	到处
strawberry	草莓
truth	真相
decide	决定
change	改变
habit	习惯
usual	通常的
health	健康
saying	俗语
awful	可怕的
remember	记得
information	信息
keep	保持
brain	大脑
ping-pong	乒乓球
success	成功；胜利
event	竞赛项目；大事
throw	投；掷；扔
winner	获胜者
teammate	队友
outdoors	在户外
weight	重量
couch	长沙发
air	空气；天空
lucky	幸运的
side	侧边
nation	国家；民族
hunt	打猎；搜寻
spend	花（钱）
natural	自然的；天然的
pow-wow	帕瓦（舞蹈）
step	步骤；脚步
towards	朝向
brush	刷；刷子
tooth	牙齿
organized	有条理的；有组织的
mess	杂乱；肮脏
develop	发展；培育
final	最终的；最后的
exam	考试；检查
tennis	网球
rights	权利
care	照料
pet	宠物
puppy	小狗
rocket	火箭
alone	独自的
field	旷野；领域
luckily	幸运地
baseball	棒球
snack	点心；小吃
pop	汽水
if	如果
ever	曾经；究竟
root	加油
toot	嘟嘟（喇叭声）
shame	羞愧
noon	中午
hamburger	汉堡包
nature	大自然
wish	希望
Germany	德国
university	大学
organize	组织
camp	露营；营地
share	分享
physics	物理学
recent	最近的
perform	表演；演出
advise	劝告；建议
agree	同意
glue	胶水；用胶水粘
immediately	立即地
glad	高兴的
ahead	在前面
pancake	薄饼
lemon	柠檬
pizza	比萨饼
hate	憎恨
either	也（用在否定句中）
comb	梳子；用梳子梳头
pea	豌豆
pod	豆荚
copy	抄写；复制
surprise	使惊奇
angrily	愤怒地
lend	借出
cheat	作弊；欺骗
following	接着的；接下来
gym	体育馆；健身房
embarrassed	尴尬的
enemy	敌人
deal	交易；处理
someone	某人
England	英格兰
knowledgeable	博学的
discuss	讨论
patient	病人；有耐心的
piano	钢琴
jeans	牛仔裤
pleasure	愉快；满足
local	本地的；当地人
geography	地理
sometime	在某时
painter	画家
timetable	时间表
physical	身体的
runner	跑鞋
except	除了……之外
tonight	今晚
since	自……以后；因为
poor	可怜的；贫穷的
cough	咳嗽
because	因为
seem	好像；似乎
convenient	方便的
download	下载
librarian	图书管理员
suddenly	突然地
rush	冲；奔
into	进入；到……里
shout	喊
whisper	小声说话
quarter	四分之一
recently	最近；不久前
southern	南方的
tourist	游客
mine	我的
ocean	海洋
remind	提醒
finally	最后；终于
discussion	讨论
celebrate	庆祝
mid-	在中间
lunar	月球的；农历的
round	圆的；周而复始地
celebration	庆祝
however	然而；不过
thanksgiving	感恩节
wonder	好奇；想知道
memory	回忆；记忆力
past	过去；在……之后
album	册；专辑
choose	选择
collection	收集品
slide	幻灯片
record	录像；记录
view	观点；想法
lively	充满活力的
birth	出生
attend	参加
touch	接触
size	尺寸
fit	合适；合身
anyway	无论如何
style	款式
hug	拥抱
turkey	火鸡
meal	餐；饭
gathering	聚会
dessert	甜点
conversation	对话；交谈
thirteenth	第十三（的）
tape	胶带
post	邮寄
yet	仍旧（用于否定句中）
address	地址
top	顶部
stamp	邮票
postman	邮递员
fashion	时尚
balloon	气球
candle	蜡烛
deep	深的
breath	呼吸
blow	吹
neighbourhood	街区
perfect	完美的
thirsty	饥渴的
complete	完成；结束
bakery	面包店
biscuit	饼干
downtown	市中心
coffee	咖啡
through	穿过
cherry	樱桃
sidewalk	人行道
himself	他自己
entrance	入口
pond	池塘
freeze	结冰；冻僵
hockey	冰球；曲棍球
block	接到；栋；幢
bank	银行
whole	整个的；完全的
chat	聊天
cost	花费
interview	面试；采访
tailor	裁缝
fix	修理
sound	听起来；声音
enjoyable	令人愉快的
treat	对待
flu	流感
mile	英里
across	横过
might	可能；也许
scientist	科学家
grow	生长；增加
engineer	工程师
page	页
yearbook	年刊
airplane	飞机
pilot	飞行员
fear	害怕；担忧
height	高度；身高
overcome	解决；克服
model	模型
advice	建议；劝告
diamond	钻石
number	数字；号码
seventeen	十七
eighteen	十八
opposite	相反的；相对的
crop	庄稼
manager	经理
business	买卖；生意
company	公司
creative	创造性的
goal	目标
ambition	抱负；雄心
fisherman	渔夫
policewoman	女警察
artist	艺术家
choice	选择
path	途径；小路
strict	严格的
punish	惩罚
wise	明智的
actor	（男）演员
transportation	交通；运输
hometown	故乡
Britain	英国
seldom	罕见；不常
rapid	快速的
steam	蒸汽
engine	发动机；引擎
wheel	车轮
born	出生；诞生
passenger	乘客
railway	铁路
most	大多数；最多的
station	站；车站
easily	容易地
standard	标准；规格
speed	速度
per	每一
wing	翅膀
pull	拉；拖
cart	手推车
skateboard	滑板
able	能够
power	驱动；力量
machine	机器
space	空间；太空；距离
spaceship	宇宙飞船
imagine	想象
environment	环境
presentation	介绍；陈述
invention	发明；创造
backpack	背包
cardboard	硬纸板
fuel	燃料
oil	油；石油
probably	大概
imagination	想象
hoverboard	飞翔器
smooth	平稳的；光滑的
float	漂浮
transporter	运输车
allow	允许
form	形式；形状
pedal	踏板；踏……踏板
than	比
energy	能量
hobby	爱好
spare	空闲的
earth	地球；大地
collect	收集
stone	石头
concert	音乐会
ticket	票；券
trade	交易
garden	花园；种植
confidence	自信
postcard	明信片
outdoor	户外的
giant	巨人；巨大的
huge	极大的
African	非洲（人）的
hen	母鸡
anymore	再也（不）
launch	发射
adult	成年人
break	休息；弄坏
land	陆地；降落
challenging	挑战性的
spin	（使）快速旋转
performance	表演
common	普通的；一般的
real	真正的
support	支持
daily	每天；每天的
unique	独特的
suppose	假定；认为
ourselves	我们自己
person	人
talent	天赋；才智
personal	个人的
strength	力量；长处
sense	意义；感觉
Greece	希腊
nobody	没有人
return	返回；回应
Greek	希腊人；希腊（人）的
junior	初级（的）；儿童的
continue	继续
average	平均（的）
stupid	愚蠢的
smart	聪敏的
impossible	不可能的
weak	弱的
mirror	镜子
microphone	麦克风
program	节目；程序；计划
confident	自信的
voice	嗓音
excellent	优秀的
stage	舞台
heart	心脏
beat	跳动；敲打
slowly	慢慢地
herself	她自己
loser	输者
fail	不及格；失败
Mexico	墨西哥
misspelled	拼错的
accept	接受
award	奖品
college	大学；学院
shower	阵雨；淋浴
thunderstorm	雷雨
thunder	雷（声）
sunrise	日出
sunset	日落
rise	升起；增加
set	（日/月）落沉；设置
exact	精确的
neither	（两者）都不
nor	也不
boot	靴子
jasmine	茉莉
blossom	花朵；开花
sunshine	阳光
Tai	Chi	太极
swing	秋千
melt	融化
hillside	小丘
wind	风；气流
gently	温柔地；轻轻地
budding	正发芽的
nearly	几乎；差不多
millimeter	毫米
plenty	丰富；大量
anytime	任何时候
babysit	照顾婴儿
bar     栏；门栓；（酒）吧
instead	代替
push	推
soccer	（英式）足球
shall	将；会
rabbit	兔子
low	低的；浅的
below	在……下面
zero	零
until	直到……为止
groundhog	土拨鼠
bush	灌木
hole	洞
large	大的
root	根
seedling	幼苗
cover	覆盖；盖子
fill	装满
dirt	泥土
pack	堆积
dust	沙尘
storm	暴风雨
dirty	不干净的
northern	北方的
bottom	底部；下方的
pleasant	使人愉快的
shade	阴影；树荫
fulfil	达到；执行
basic	基础的
soil	土壤
channel	频道
gardener	园丁；花匠
log	登录；记录
consider	考虑；认为
sunlight	阳光
test	测试；考查
compost	混合肥料
dry	干的；使变干
nearby	在附近；不远
squirrel	松鼠
fence	栅栏；篱笆
purpose	目的；意图
egret	白鹭
eastern	东方的
shy	害羞的
tightly	紧紧地
fossil	化石
southwest	西南（的）
living	活着的
agriculture	农业
seed	种子
pot	盆；壶；瓶
sprout	发芽
stem	茎；干
bud	花蕾；发芽
carefully	仔细地
yard	院子
scare	惊吓
doorbell	门铃
scream	尖叫
tiny	微小的
sofa	长沙发
vacation	假期
gentle	温和的
loyal	忠诚的
long-eared	长耳的
jerboa	跳鼠
mouse	老鼠；鼠标
kiwi	几维鸟
lay	放置；产卵
long-nosed	长鼻子的
eggplant	茄子
shake	摇动
flap	拍打
avoid	避开
danger	危险；风险
dangerous	危险的
mainly	主要地
bamboo	竹子
giraffe	长颈鹿
escape	逃脱
fierce	凶猛的
protect	保护
fool	愚人
century	世纪
fur	（兽类的）毛
symbol	标志；象征
courage	勇气；胆量
brave	勇敢的
chain	链条
balance	平衡
reason	理由；原因
disappear	消失
kill	杀死
cut	砍；切；割
decrease	减少
friendship	友谊
rhino	犀牛
skin	皮肤
warn	警告
insect	昆虫
relationship	关系
survive	生存
hippo	河马
tortoise	龟
truly	真正地
boundary	边界
technology	技术
desktop	（电脑）桌面；台式电脑
tablet	平板电脑
keyboard	键盘
invitation	邀请
industry	工业
laptop	笔记本电脑
Easter	复活节	enter	进入；输入
key	关键；钥匙；按键
search	搜索
topic	话题
depend	依靠；取决于
bunny	兔子
hide	隐藏；躲避
press	印刷机；新闻界
appear	出现
modern	现代的
electronic	电子的
sell	出售
receive	收到
cancer	癌症
blessing	祝福
pyramid	金字塔
Egypt	埃及
advantage	优势
disadvantage	劣势
simple	简单的
coin	硬币
cause	造成；引起
less	更少/小的（地）
aside	除……之外；在旁边
attack	攻击；损害
web	网络
steal	偷盗
banking	银行业
properly	正确地
pay	支付
bake	烘烤
dollar	（美/加/澳）元
sixteen	十六
advertising	广告活动
poster	海报
cheap	便宜的
pocket	口袋；赢得
tie	领带；系/栓/绑
while	当……时候
afford	买得起；（有时间）做
cent	分
everyday	每天的；日常的
ladder	梯子
position	位置
congratulate	祝贺
including	包括
account	账目
husband	丈夫
gate	大门
appreciate	感激
honesty	诚实
trusting	信任的
honest	诚实的
value	价值
motto	格言
trust	相信
battle	战斗
create	创造
ad	广告
customer	客户
already	已经
similar	类似的
sample	样品
offer	提供
shine	发光；反射
quality	质量
surely	当然
succeed	成功
crazy	疯狂的
baker	面包师傅
champion	冠军
relative	亲戚
thick	厚的
photograph	照片
lift	抬起；电梯
weigh	有……重
kilo	千克
several	一些
BC	公元前
athlete	运动员
compete	竞争
Olympia	奥林匹亚
married	已婚的
host	主人；主办
Olympic	奥林匹克运动会的
amazed	惊讶的
spirit	精神
represent	代表；象征
continent	大陆
America	美国；美洲
torch	火炬
peace	和平
slogan	口号；标语
reflect	表明；反映
mascot	吉祥物
feature	特征
fairly	公平合理地
defeat	打败
gold	金色（的）
medal	奖牌；勋章
influence	影响
Brazil	巴西
diving	跳水
badminton	羽毛球
coach	教练；辅导老师
rope	绳
sit-up	仰卧起坐
push-up	俯卧撑
race	赛跑；速度竞赛
result	结果；成绩
none	一个也没有
twentieth	第二十（的）
population	人口
abroad	在国外
Japan	日本
Japanese	日本人（的）；日语
Antarctica	南极洲
island	岛屿
Pacific	太平洋
planet	行星
billion	十亿
total	总数；总计的
increase	增加；增大
surface	表面
Indian	印度人（的）
Atlantic	大西洋（的）
Arctic	北极的
British	英国人（的）
washroom	盥洗室
bathroom	浴室；盥洗室
spell	拼写
pronunciation	发音
grammar	语法
translate	翻译
American	美国人（的）
Australian	澳大利亚人（的）
pronounce	发音
greet	欢迎；迎接
European	欧洲人（的）
kiss	吻
cheek	脸颊
nod	点头
thumbs-up	翘拇指；很棒
polite	有礼貌的
lip	嘴唇
rude	粗鲁的
Italian	意大利人（的）
prepare	准备
Amazon	亚马逊河
rainforest	（热带）雨林
Turkey	土耳其
Nile	尼罗河
Sahara	撒哈拉沙漠
Cairo	开罗
pride	引以自豪的事物/人
million	百万
square	广场；正方形
Rocky	落基山脉
Spanish	西班牙人（的）
Mexican	墨西哥人（的）
schoolyard	校园
attention	注意
rubbish	垃圾
garbage	垃圾
pollution	污染
explain	解释
reduce	减少
reusable	可重复利用的
least	最少/小的（地）
pollute	污染
skip	跳绳
packaging	包装
leaky	渗漏的
waste	浪费
litre	公升
sink	水槽
electricity	电
shut	关上
sort	分类；整理；类型
empty	弄空；空的
metal	金属
plastic	塑料（的）
recycle	回收再用
amount	数量
litter	垃圾；乱扔
leak	渗漏
tap	龙头；阀门
beer	啤酒
truck	货车
recycling	回收利用
factory	工厂
unlike	不像
bee	蜜蜂
ant	蚂蚁
dove	鸽子
die	死亡
dead	死的
species	物种
respect	尊重
used	用过的
divide	分开
pile	大量
seat	座位
lid	盖子
ton	吨
duty	责任；义务
九年级
stomach	胃部
regret	懊悔
fever	发烧
pale	苍白的；浅色的
examination	检查；考试
pain	疼痛
pardon	原谅
X-ray	X	光
dentist	牙医
refuse	拒绝
toothache	牙痛
rotten	腐烂的
fortunately	幸运地
headset	（头戴式）耳机
aching	疼痛的
German	德国（人）的；德语
wolf	狼
grain	谷物；粮食
vitamin	维生素
mineral	矿物质
fibre	纤维素
corn	玉米
protein	蛋白质
bean	豆子
Asian	亚洲（人）的
soy	大豆
calcium	钙
bone	骨头
yogurt	酸奶
contain	包含
balanced	均衡的
diet	日常食物
include	包含
smoke	烟；吸烟
harmful	有害的
disease	疾病
lung	肺
harm	伤害
breathe	呼吸
public	公开的
law	法律
cigarette	香烟
whenever	无论何时
risk	风险
somebody	某人
damage	损害
unable	不能的
dare	敢于
wheelchair	轮椅
control	控制
telephone	电话
hers	她的
cheer	欢呼（声）
kick	踢
disabled	残疾的
focus	集中；焦点
pity	同情
appendicitis	阑尾炎
appendix	阑尾；附录
sleepy	困倦的
mention	提到
meaning	意义
dialogue	对话
successful	成功的
missing	缺失的
survey	调查
neighbour	邻居
universe	宇宙
lifetime	一生
solve	解决
theory	理论
relativity	相对性
Switzerland	瑞士
pioneer	先锋
Princeton	普林斯顿
nuclear	核能的
weapon	武器
conclusion	结论
false	错误的
peanut	花生
hybrid	杂交的（植/动物）
variety	变化
introduction	采用；引进
leader	领袖
production	生产
produce	生产
super	超级的
planetary	行星的
writer	作家
educator	教育家
blind	失明的
deaf	失聪的
illness	疾病
ability	能力
progress	进展；进步
community	社区
greatly	非常
graduate	毕业
Toronto	多伦多
remain	保持不变
anti-	反对
decision	决定
aid	帮助
worst	最糟糕的
condition	条件
operate	做手术
government	政府
medical	医疗的
crossword	纵横游戏
puzzle	智力游戏
based	以……为基础
whom	谁
anybody	任何人
chemistry	化学
safety	安全
careful	小心的
decorate	装饰
hang	悬挂
ceiling	天花板
lie	平躺；说谎；谎言
serious	严肃的
ambulance	救护车
necessary	必须的
accident	意外；事故
town	城镇
reporter	记者
roll	滚动
fault	缺点；过错
icy	结满冰的
ugly	难看的
shoulder	肩膀
wound	伤口
recover	恢复
expect	期待
helmet	头盔
sudden	突然（的）
blood	血
knee	膝盖
bleed	流血
sharp	锋利的
rock	岩石
stick	插入
scary	恐怖的
goodness	善良；美德
stranger	陌生人
careless	粗心的
prevent	阻止；预防
certain	某些
themselves	他/她/它们自己
baking	烘焙
soda	苏打
salt	盐
scissors	剪刀
knife	刀
poison	毒药
heat	高温；加热
burn	燃烧
bathtub	浴缸
slip	滑到
earthquake	地震
calm	镇静的
object	物体；目标
system	系统
survival	生存
rule	规则
branch	树枝
training	训练
compare	比较
passage	章节；段落
limit	限制
format	格式
rhyme	韵脚；押韵
although	尽管；虽然
effort	精力；努力
fat	脂肪；胖的
aloud	出声地
line	路线；（诗）行
text	正文；文字材料
poet	诗人
single	单一的
screen	屏幕
hum	发嗡嗡声
stretch	伸展
liquid	液体；清澈的
state	陈述；说明
noun	名词
adjective	形容词
express	表达
fable	寓言
woodcutter	伐木工
axe	斧子
dive	跳水
admit	承认；赞同
silver	银（的）
policy	原则；政策
loud	大声的
frightened	受惊的
board	木板
awake	醒着的
musician	音乐家
perhaps	也许
peek	偷窥
softly	轻轻地
scene	场景；景色
crawl	爬行
selfish	自私的
knock	敲打
spread	扩展
neck	脖子
wicked	邪恶的
fairy	小精灵
tale	童话；故事
character	人物；特点
plot	情节
humorous	幽默的
experiment	实验
jar	罐子
upside	上部
pour	倾倒
correct	正确的
scientific	科学的
method	方法
raincoat	雨衣
force	力量；迫使
pressure	压力；压强；挤压
conclude	得出结论；断定
holder	支托物；持有者
shallow	浅的
lighter	打火机；点火器
match	火柴；匹配
examine	检查
oxygen	氧气
telescope	望远镜
solar	太阳的
certainly	当然；确定
unless	除非
double	两倍（的）
mystery	奥秘
biology	生物
butterfly	蝴蝶
migrate	移居
fantastic	奇异的
completely	完全地
grandchild	（外）孙子/女
female	女性；雌性
milkweed	马利筋（植）
chemical	化学物质
puzzling	令人费解的
DNA	脱氧核糖核酸
blueprint	蓝图
general	一般的；普遍的
complex	复杂的
twin	双胞胎之一
repeat	重复
pattern	模式
identify	确认
related	有关的
grandson	孙子；外孙
granddaughter	孙女；外孙女
instruction	说明；指示
affect	影响
suggest	建议
development	发展
mobile	phone	移动电话
discovery	发现；发掘
involve	参加；包含
script	剧本
director	导演；主任；负责人
direct	导演；指导
costume	服装；戏装
background	背景
task	任务
effect	影响
France	法国
couple	两/几个人（物）
titanic	巨大的
action	行动
prefer	更喜欢
fiction	小说；虚构
comedy	喜剧
popcorn	爆米花
goldfish	金鱼
wife	妻子
net	网络
whatever	无论什么
God	上帝
grey	灰色（的）
marry	结婚
ours	我们的
coast	海岸
handbag	手提包
among	在……中间
servant	仆人
guard	卫兵；看守
queen	女王
serve	服务
mad	疯的；发怒的
crash	撞击
handsome	英俊的
playwright	剧作家
tragedy	悲剧
teahouse	茶馆
actress	女演员
victory	胜利
beat	击败
repair	修理
service	服务
message	信息
check	检查
secretary	秘书
bounce	反弹
separate	分离
behave	表现
gentleman	绅士
president	总统
council	议会
organization	组织
provide	提供
agreement	协议
religion	宗教
dispute	争论
olive	橄榄
flood	洪水
snake	蛇
lock	锁
suffer	受苦
headquarters	总部
security	安全
permanent	永久的
situation	状况
satisfy	使满意
forever	永远
silence	沉默
silent	沉默的
elder	长辈
directly	直接地
rather	相当；宁可
peacemaker	调解人
Chinatown	中国城；唐人街
decoration	装饰品
bowl	碗
chopstick	筷子
spoon	勺子
fork	叉子
underground	地下的
lantern	灯笼
dragon	龙
Santa	Claus	圣诞老人
temple	庙宇
society	社会
generation	一代（人）
wealthy	富有的
penny	便士
pound	镑
foolish	愚蠢的
whether	是否；无论
human	人类（的）
manners	礼仪
though	尽管
modest	谦虚的
virtue	美德
praise	称赞
private	私人的
elderly	年长的
guest	客人
extra	额外的
waiter	服务员
tip	（给）小费
percent	百分之……
central	中部的
immigrant	移民
according	to	根据；依照
official	官方的；正式的
custom	习惯；习俗
tidy	整洁的；使整洁
Russian	俄罗斯人	(的)；俄语
noisy	吵闹的
chalk	粉笔
tradition	传统
reaction	反应
react	反应
officer	官员
gun	枪
doll	洋娃娃
misunderstanding	误解
require	需要
communication	交流
hardly	几乎不
solution	解决办法；答案
anger	愤怒
interpersonal	人际的
passport	护照；途径
proper	正确的；恰当的
listener	听者
contact	接触；联系
promise	承诺
cancel	取消
figure	计算；认为
difficulty	困难
dining	用餐
simply	只是；简单地
somehow	以某种方式
adapt	使适应；改编
universal	通用的；普遍的
absent	缺席的
trouble	麻烦；困难
secret	秘密（的）
moment	时刻；瞬间
tap	轻拍
familiar	熟悉的
boss	老板
manage	管理；负责
doubt	怀疑
wealth	财富
astronaut	宇航员
besides	除……之外
weekday	工作日
primary	小学的；基本的
asleep	睡着的
notebook	笔记本
review	复习；评论
itself	它自己
wallet	钱包
owner	拥有者
row	划（船）
senior	级别高的
speech	演讲
period	一段时间
valuable	宝贵的
achieve	获得
behalf	代表（某人）
congratulation	祝贺
merchant	商人
mall	商场
faint	昏倒
agency	机关；代理机构
definitely	肯定